NO textures/shingle.xpm
WE textures/greybrickwall007x800.xpm
SO textures/wood2.xpm
EA textures/StoneFloorTexture.xpm

F 220,100,255
C 0,0,0




11111111
11000001111111111111111111111111111
11000011000000000000000000000000111
11000N0000001111111111111000000100011111
1101110111111            111111000000001
111111111111               1111111111111
